####################
#..................#
#..................#
#..................#
#..................#
#........p.........#
#E................E#
####################