........................................
#......................................#
#......................................#
#......................................#
#......................................#
#......................................#
#......................................#
#......................................#
#......................................#
#......................................#
#......................................#
#......................................#
#......................................#
#......................................#
#......................................#
#......................................#
#......................................#
#......................................#
#......................................#
#......................................#
#......................................#
#...E...............P..............E...#
#......................................#
#......................................#
#......................................#
#......................................#
#......................................#
#......................................#
________________________________________
########################################