........................................
#......................................#
#......................................#
#......................................#
#......................................#
#......................................#
#......................................#
#......................................#
#......................................#
#......................................#
#......................................#
#......................................#
#......................................#
#......................................#
#......................................#
#......................................#
#......................................#
#......................................#
#......................................#
#......................................#
#......................................#
#...E...............P..............E...#
#......................................#
#......................................#
#......................................#
#......................................#
#......................................#
#......................................#
########################################
########################################