........................................
#......................................#
#......................................#
#......................................#
#......................................#
#......................................#
#......................................#
#......................................#
#......................................#
#......................................#
#......................................#
#......................................#
#......................................#
#......................................#
#......................................#
#......................................#
#......................................#
#......................................#
#......................................#
#......................................#
#......................................#
#.....E.............P............E.....#
#......................................#
#......................................#
#......................................#
#......................................#
#......................................#
#......................................#
________________________________________
########################################