........................................
#......................................#
#......................................#
#......................................#
#......................................#
#......................................#
#......................................#
#......................................#
#......................................#
#......................................#
#......................................#
#......................................#
#......................................#
#......................................#
#......................................#
#......................................#
#......................................#
#......................................#
#......................................#
#......................................#
#......................................#
#...................P..................#
#......................................#
#......................................#
#.....E..........................E.....#
#......................................#
#......................................#
#......................................#
________________________________________
########################################